NO ./textures/volcano-wall.xpm
SO ./textures/volcano-wall.xpm
WE ./textures/volcano-wall.xpm
EA ./textures/volcano-wall.xpm

F 117, 0, 0
C 48, 0, 0

111111
100001
101101
101101
100101
100001
1011S1
111111