NO ./textures/N.xpm
SO ./textures/S.xpm
WE ./textures/W.xpm
EA ./textures/E.xpm

F 84, 64, 0
C 166, 139, 53

1111111111111  111
100000000100111001
101101100100111001		111111
101101110110110001		100E01
100101000110000001		100001
100001000100111111		111111
101101000000111  1
111111111111111111
