
NO ./textures/image.xpm


F 0, 255,	0
SO ./textures/image.xpm
C  225 ,30,0

WE 		./textures/image.xpm
EA ./textures/image.xpm






























    1
11111111111 111    	111111
1000000000010N1   	111111
100000000000011     101111
111111111111111     111111