NO ./textures/image.xpm
SO ./textures/image.xpm
WE ./textures/image.xpm
EA ./textures/image.xpm

F 191,160,116
C 229,227,196



11111111
10000N01
100S0001
11111111
