NO ./textures/image.xpm
SO ./textures/image.xpm
WE ./textures/image.xpm
EA ./textures/image.xpm

F 191, 10, 1
C 229,227,196

11111111
10000101
10000001
11111111
