NO ./textures/image.xpm
SO ./textures/image.xpm
WE ./textures/image.xpm
EA ./textures/image.xpm

F 191, 10, 1
F 191, 10, 1
C 229,227,196

11111111
10000N01
10000001
11111111
