NO ./textures/image.xpm
SO ./textures/image.xpm
WE ./textures/image.xpm
EA ./textures/image.xpm

FLOOR 191, 10, 1
C 256,227,196


11111111
10000S01
10000001
11111111
