NO ./textures/Wood1.xpm
SO ./textures/Wood2.xpm
WE ./textures/Wood3.xpm
EA ./textures/Wood4.xpm

F 196, 178, 153
C 23, 18, 11

111111    11111
100001    10001
101101    11001
101101111111101
100101    10001
100001    10011
101101    1W111
111111    11111