NO ./textures_marias/ice.xpm
SO ./textures_marias/ice.xpm
WE ./textures_marias/ice.xpm
EA ./textures_marias/ice.xpm

F 139, 188, 204
C 9, 33, 41

1111111111
1000000001
1011011001
1011011101
1001010001
1000010001
1011N10001
1111111111