NO ./textures_marias/N.xpm
SO ./textures_marias/S.xpm
WE ./textures_marias/W.xpm
EA ./textures_marias/E.xpm

F 84, 64, 0
C 166, 139, 53

1111111111111  111
100000000100111001
101101100100111001
101101110110110001
100101000110000001
100001000100111111
101101000W00111  1
111111111111111111